NO ./path_to_the_north_texture
SO  ./path_to_the_south_texture
WE ./path_to_the_west_texture
EA ./path_to_the_east_texture

C 200, 30, 0
F 200, 30, 0


        11111111111 11111111111111
        10000000001 10000011111001    
        10110000011110000S1   1011
        100100000000000000011 11
11111111101100000111000000001 101
10111110001100000111011111111 111
11    11111111011100000010001
11 11111111111011101010010001
11 11000110101011100000011111
     1         0  1       1    
     1100000000001100000011111
11111000000000001101010010001
1100000111010101111101111010111
11110111 1110101 101111010001
11111111 1111111 111111111111
